22222222222222
00000000000000
00000000000000
00000000000000
00000000022200
00220000000000
00000000000000
00000000000000
