23143241234321
00000000000000
00000000000000
00000000000000
00000000055500
00550000000000
00000000000000
00000000000000
